13 14
+-------++--------+-----+-+
|       ||        |     | |
| +---+ ++---+--+ +-- + | |
|     | ||      | |   | | |
+---+ | ++ +-++ | + + | | |
|     |    |    |   | | | |
| +-+ +-++-+ ++ +-+-+-+ + |
| | | | || | || | | |     |
| | | | || | || | | |     |
| | +-+ || +-++-+ | + +-+ |
| | |   ||    |   |   |   |
| + | + ++---+| + +---+ + |
|   | |      || |       | |
| +-+ | ++---++ | +-----+ |
|     | ||      | |       |
+-+---+ || +----+ | +-+ + |
| |     || |      | |   | |
| | +---++ | ++---+ |---+-+
| |        |        |     |
| | +----+ |  +---+ |+--+ |
| | |    | |  |   | ||  | |
| | |    | |  |   | ||  | |
| | +----+ |  +---+ |+--+ |
| |        |        |     |
| +---+ ++-+-+--+ +-+ +-+ |
|     |    | |  |   | | | |
| +-+ | ++ | ++ | + |-+ | |
|   | | || |  | | | |   | |
+-+ | + || + +| + | +---+ |
|   |   ||   ||   |       |
+---+---++---++---+-------+
